 lga_code18, regional_mig_internal_mig_departures_num, regional_mig_ovs_mig_arrivals_num, est_res_pop_ur_erp_30_jun_p_tot_num, regional_mig_ovs_mig_net_mig_num, lga_name18, regional_mig_internal_mig_net_mig_num, regional_mig_ovs_mig_departures_num, ogc_fid, pop_density_pop_density_p_p_km2, regional_mig_internal_mig_arrivals_num
24600,16649,24295,169961,8873,Melbourne (C),1047,15422,78,4550.3,17696
26610,1434,238,20759,149,Swan Hill (RC),-364,89,134,3.4,1070
23810,4134,381,75211,240,Latrobe (C) (Vic.),-172,141,155,52.8,3962
23430,11688,3522,163431,2129,Kingston (C) (Vic.),-430,1393,162,1788.7,11258
24850,3356,374,44299,234,Mitchell (S),799,140,169,15.5,4155
24780,3041,737,55515,462,Mildura (RC),-319,275,190,2.5,2722
21270,393,27,6184,17,Buloke (S),-16,10,232,0.8,377
20740,2309,192,35327,121,Bass Coast (S),871,71,309,40.8,3180
25620,965,83,14478,52,Murrindindi (S),193,31,358,3.7,1158
25990,610,16,7353,9,Pyrenees (S),-22,7,456,2.1,588
25900,11615,5283,113200,2178,Port Phillip (C),-466,3105,442,5466.2,11149
26080,269,22,2982,14,Queenscliffe (B),27,8,610,346.1,296
27260,14685,7613,255322,4717,Wyndham (C),5472,2896,638,471,20157
24250,558,100,8979,62,Mansfield (S),121,38,645,2.3,679
25150,2228,130,34158,81,Moorabool (S),419,49,673,16.2,2647
21750,1155,131,21503,83,Colac-Otway (S),-93,48,750,6.3,1062
26260,983,90,16135,56,Southern Grampians (S),-79,34,890,2.4,904
23190,1189,91,19875,57,Horsham (RC),-135,34,897,4.7,1054
21180,14709,5078,208714,3189,Brimbank (C),-3232,1889,904,1691.4,11477
22620,5224,807,116045,501,Greater Bendigo (C),980,306,848,38.7,6204
23110,7262,1885,96470,1114,Hobsons Bay (C),-422,771,813,1501.7,6840
20830,3127,213,52015,132,Baw Baw (S),1015,81,946,12.9,4142
25250,14891,6388,181725,3542,Moreland (C),-194,2846,974,3566.6,14697
26810,3000,295,44019,186,Wellington (S),-25,109,1044,4.1,2975
22410,1205,55,19665,34,Glenelg (S),-39,21,1072,3.2,1166
22310,11907,5649,153858,2775,Glen Eira (C),-1097,2874,1030,3976.6,10810
26490,2112,275,32251,171,Surf Coast (S),527,104,1065,20.8,2639
25060,9049,2981,127883,1750,Moonee Valley (C),52,1231,1156,2964.5,9101
21670,794,30,13209,18,Central Goldfields (S),94,12,1221,8.6,888
21610,19431,6150,340419,3865,Casey (C),5953,2285,1275,831.4,25384
27450,9553,1021,158173,642,Yarra Ranges (S),-342,379,1282,64.1,9211
25490,1225,114,16887,72,Moyne (S),-43,42,1205,3.1,1182
23670,11471,2258,163203,1414,Knox (C),-808,844,1450,1432.7,10663
26430,708,60,10645,38,Strathbogie (S),161,22,1436,3.2,869
27070,11585,4900,223322,3076,Whittlesea (C),2060,1824,1569,456,13645
23940,510,22,7513,14,Loddon (S),8,8,1527,1.1,518
25710,4129,496,64941,311,Nillumbik (S),-369,185,1618,150.2,3760
21010,961,43,14024,26,Benalla (RC),47,17,1660,6,1008
22490,1645,48,23120,30,Golden Plains (S),349,18,1667,8.6,1994
26350,11179,5557,116207,2124,Stonnington (C),-152,3433,1709,4530.2,11027
23350,1144,52,16490,33,Indigo (S),115,19,1716,8.1,1259
20570,5311,878,107325,547,Ballarat (C),883,331,1730,145.2,6194
22750,10517,2995,252217,1862,Greater Geelong (C),3663,1133,1751,202.1,14180
20110,809,115,12730,72,Alpine (S),42,43,1758,2.7,851
22110,2326,155,46818,97,East Gippsland (S),635,58,1772,2.2,2961
25340,9568,1157,165822,701,Mornington Peninsula (S),1208,456,1786,229,10776
26890,287,8,3862,4,West Wimmera (S),-43,4,1901,0.4,244
25430,1233,108,19514,67,Mount Alexander (S),180,41,1849,12.8,1413
21110,13849,6464,181289,2375,Boroondara (C),-1068,4089,1912,3012.6,12781
26170,1810,118,29576,74,South Gippsland (S),151,44,1996,9,1961
21890,13219,5344,161609,3098,Darebin (C),-1198,2246,2031,3022.4,12021
24330,8881,3431,91387,2099,Maribyrnong (C),-949,1332,2073,2926.7,7932
21370,2380,122,37592,76,Campaspe (S),-58,46,2010,8.3,2322
25810,772,67,11431,42,Northern Grampians (S),-99,25,2046,2,673
24130,2934,248,49388,156,Macedon Ranges (S),627,92,2122,28.2,3561
22170,11032,1256,141845,788,Frankston (C),-664,468,2094,1094.5,10368
24650,9165,2154,156713,1354,Melton (C),4807,800,2178,297.1,13972
22250,643,8,10547,4,Gannawarra (S),3,4,2199,2.8,646
26980,13534,7783,176196,4317,Whitehorse (C),-2076,3466,2143,2741.1,11458
20660,9888,2256,130237,1289,Banyule (C),-922,967,2360,2082.5,8966
21830,1056,66,16140,42,Corangamite (S),-86,24,2416,3.7,970
20260,723,102,11795,64,Ararat (RC),-9,38,2430,2.8,714
23270,10971,5162,224394,3234,Hume (C),3091,1928,2710,445.4,14062
26700,1385,128,29087,78,Wangaratta (RC),138,50,2465,8,1523
27630,507,24,6658,15,Yarriambiack (S),-11,9,2486,0.9,496
22980,430,21,5645,14,Hindmarsh (S),-85,7,2535,0.8,345
24900,1947,179,29799,113,Moira (S),11,66,2549,7.4,1958
22910,1149,79,15812,50,Hepburn (S),126,29,2741,10.7,1275
21450,7838,871,107120,547,Cardinia (S),2986,324,2661,83.5,10824
20910,6983,2411,105718,999,Bayside (C),278,1412,2675,2841,7261
22670,12799,6275,166094,3940,Greater Dandenong (C),-2858,2335,2815,1282.1,9941
24210,8294,3321,125508,1959,Manningham (C),-887,1362,2836,1107.3,7407
27350,10757,4064,98521,1886,Yarra (C),-167,2178,2829,5041.4,10590
24410,9302,1824,117498,1137,Maroondah (C),-669,687,2876,1913.3,8633
22830,3789,858,66007,537,Greater Shepparton (C),-514,321,2913,27.3,3275
26670,474,14,6054,9,Towong (S),9,5,2983,0.9,483
29399,62,9,889,6,Unincorporated Vic,-20,3,2997,3.1,42
24970,15619,12157,200077,6329,Monash (C),-3718,5828,3109,2455.4,11901
26730,2016,468,34862,293,Warrnambool (C),-68,175,3333,288.2,1948
27170,3591,302,41429,188,Wodonga (C),156,114,3774,95.7,3747